1, 62, 2
1, 167, 1
2, 31, 1
2, 174, 1
3, 54, 1
3, 93, 1
3, 95, 1
3, 124, 1
3, 126, 1
3, 132, 1
4, 3, 1
4, 5, 1
4, 141, 1
5, 1, 1
5, 5, 1
7, 87, 1
7, 89, 1
9, 12, 1
9, 74, 1
9, 85, 1
10, 173, 1
13, 1, 1
13, 78, 1
13, 86, 1
14, 14, 1
14, 16, 1
14, 22, 2
16, 1, 1
16, 3, 1
16, 9, 1
16, 86, 1
16, 88, 1
18, 179, 1
19, 30, 1
19, 32, 1
19, 120, 1
19, 126, 1
19, 128, 1
19, 164, 1
19, 166, 1
19, 173, 1