1, 48, 1
2, 109, 1
5, 22, 2
5, 109, 1
6, 50, 1
7, 51, 1
11, 73, 1
13, 52, 1
13, 114, 1
14, 53, 1
15, 112, 1
16, 115, 1