0, 9, 1
1, 33, 2
1, 41, 1
2, 120, 1
3, 98, 1
5, 90, 1
5, 178, 2
6, 61, 1
10, 2, 2
10, 20, 1
10, 54, 1
10, 165, 1
10, 167, 2
10, 178, 1
12, 38, 2
12, 122, 1
12, 127, 1
13, 58, 1
13, 60, 1
13, 82, 1
15, 54, 1
15, 56, 1
17, 100, 2
17, 117, 2
17, 125, 2
19, 1, 1
19, 14, 1