0, 23, 1
0, 25, 1
1, 63, 1
1, 65, 1
1, 70, 4
1, 139, 1
3, 116, 1
3, 118, 1
3, 120, 1
4, 79, 1
4, 106, 1
4, 138, 1
4, 152, 2
4, 155, 1
5, 19, 1
5, 28, 1
5, 55, 2
5, 58, 1
5, 63, 1
5, 165, 1
10, 10, 1
11, 2, 1
13, 62, 1
13, 73, 2
13, 77, 1
13, 179, 1
14, 137, 1
14, 142, 1
15, 141, 1
15, 166, 2
15, 169, 1
15, 172, 1
15, 174, 1
16, 74, 2
17, 7, 2
17, 10, 1
17, 23, 1
17, 25, 1
17, 92, 1
18, 84, 1
18, 96, 1
18, 112, 2
18, 115, 1
18, 136, 1
19, 58, 1
19, 101, 1