1, 117, 2
1, 126, 1
2, 0, 1
2, 2, 1
2, 10, 1
2, 12, 1
12, 97, 1
12, 99, 1
12, 108, 1
12, 110, 1
12, 112, 1
15, 28, 1
15, 54, 2
15, 57, 1
15, 59, 1
15, 67, 1
15, 72, 1
17, 91, 2
17, 94, 1
17, 96, 1